1111111111111111111111111
100000000C00000C00000C001
1010010101101001000010101
1E10001101010000100010101
1C10000C00C0000C0P00000C1
1111111111111111111111111
