1111111111
10P0000001
1000000001
1000E00001
100000C001
1111111111
