111111111111111111111111111111111111111111111
100000000001E10000000000000000C00000000000001
100000000001010001000000000000C00001000000001
100000C00001010000000001000000C00000100000001
100000000001010000010010000000C00001000000001
10000000000P000000000010000000C00001000000001
100001000000000100000010000000C00001000000001
100000000000C00100000000000000C00001000000001
100000000000000100000000000000C00001000000001
111111111111111111111111111111111111111111111
