111111111111
1C00E000C001
10C0F0000C01
10C0000P0001
111111111111
