111111111111
1C000000C001
1P11000C0001
101E10000001
111111111111
