1111111111111111111111111111111111
10000000000000C00000C0000000000001
1010010100100000101001000000010101
10000010010101010001001000E0001011
1P0001001C10C0000000000000000000C1
1111111111111111111111111111111111
