1111111111111111111111111111111111
10000000000000C00000C0000000000001
1110010100100000101001000000010101
1010010010101010001001000E00010101
1P0101000C00C0000000000000000000C1
1111111111111111111111111111111111
