11111
1C001
1P001
100E1
11111
